0,0,0,0,0,0,0,0,0,0,0,0,0,0,0
0,0,0,0,0,0,0,0,0,0,0,0,0,0,72,72,0
0,0,0,0,0,0,0,0,0,0,0,0,0,72,72,72,72
0,0,0,0,0,0,0,0,0,0,0,0,0,77,77,77,77
0,0,0,0,0,0,0,0,0,0,0,0,0,77,77,77,77
0,0,0,0,0,0,0,0,0,0,0,0,0,0,154,77,77
0,0,0,0,0,0,0,0,0,0,0,0,0,0,170,77,77
0,0,0,0,0,0,0,0,74,0,0,0,71,22,21,22,22,1
0,0,0,0,0,0,0,0,0,0,28,0,2,62,18,19,19,3,,,,,,0,,,,,0
0,0,0,0,0,0,0,0,28,0,30,0,2,62,62,17,62,3,0,0,0,0,0,0,0,0,71,22,22,22,22,1
0,0,0,0,0,0,28,0,30,0,0,0,2,19,18,17,17,3,,,,,,,,,13,18,62,18,62,4
22,22,22,22,1,0,30,0,0,0,0,0,2,62,17,18,18,3,,,,,,,,,12,18,62,18,62,3
62,62,62,62,3,0,0,0,0,0,0,0,2,62,18,62,17,6,,,,,,,,,2,62,62,62,62,3
